R 1920 1080
NO ./srcs/textures/kamen.xpm
SO ./srcs/textures/21.xpm
WE ./srcs/textures/mossy.xpm
EA ./srcs/textures/crete_floor2.xpm

S ./srcs/textures/pillar.xpm
C 20,20,70
F 65,10,20
         11111111111111111111111
        1000000000110000000000001111111111111111111111111111111111111111111111111111111111
        10110000011100200000000000000000000000000000000000000000000000000000000020000001
        1001000000000000000000001111111111111111111111111111111111111111111111111111111111
111111111011000001110000000000001
100000000011000001110111111111111
11110111111111011100000010001
11110111111111011101010010201
11000000110101011100000000001
1000000000000001100000010001
10000000000000001101010010001
11000001110101011111011110N0111
11112111 1110101 101111010001
11111111 1111111 111111111111
