R 1920 1080
NO ./srcs/textures/hex.xpm
SO ./srcs/textures/block.xpm
WE ./srcs/textures/crete_floor2.xpm
EA ./srcs/textures/redbrick.xpm

S ./srcs/textures/pillar.xpm
C 15,40,90
F 60,25,25

1111111111111111111111111111111111111111111111111111111111
1200000000000000000000000000000000000000000000000000000001
1000000000000000000000000000000000000000000000000000000001
1000000000000000000000000000000000000000000W00000000000001
1000000000000000000000000000000000000000000000000000000001
11000000000000000000020000000000000000000000000000000000021
1000000000000000000000000000000020000000000000000000000001
1000000000000000000000000000000000000000000000000000000001
1000000000000000000000000000000000000000000000000000000001
1000000000000000000000000000000000000000000020000000000001
11111111111111111111111111000000000000000000000000000000001
                         100000000000000000000000011111111
                          100000000000000000000000011111111
                         100200000000002000000200011111111
                          100000000000000000000000011111111
                          11111111111111111111111101
                                                 101
                                                  1
