R 400 200
NO ./srcs/textures/kamen.xpm
SO ./srcs/textures/21.xpm
WE ./srcs/textures/mossy.xpm
EA ./srcs/textures/crete_floor2.xpm

S ./srcs/textures/pillar.xpm
C 20,20,70
F 65,10,20

1111111111111111111
1222222220222222221
1222222220222222221
1222222220222222221
1222222220222222221
1222222220222222221
1222222220222222221
1222222220222222221
1222222220222222221
1222222220222222221
1222222220222222221
1222222220222222221
1222222220222222221
1222222220222222221
1222222220222222221
1222222220222222221
1222222220222222221
1222222220222222221
1222222220222222221
1222222220222222221
1222222220222222221
1222222220222222221
1222222220222222221
1222222220222222221
1222222220222222221
1222222220222222221
1222222220222222221
1222222220222222221
1222222220222222221
1222222220222222221
1222222220222222221
1222222220222222221
1222222220222222221
1222222220222222221
1222222220222222221
1222222220222222221
1222222220222222221
1222222220222222221
1222222220222222221
1222222220222222221
1222222220222222221
1222222220222222221
1222222220222222221
1222222220222222221
1222222220222222221
1222222220222222221
1222222220222222221
1222222220222222221
1222222220222222221
1222222220222222221
1222222220222222221
1222222220222222221
1222222220222222221
1222222220222222221
1222222220222222221
1222222220222222221
1222222220222222221
1222222220222222221
1222222220222222221
1222222220222222221
1222222220222222221
1222222220222222221
1222222220222222221
1222222220222222221
1222222220222222221
1222222220222222221
1222222220222222221
1222222220222222221
1222222220222222221
1222222220222222221
1222222220222222221
1222222220222222221
1222222220222222221
1222222220222222221
1222222220222222221
1222222220222222221
1222222220222222221
1222222220222222221
1222222220222222221
1222222220222222221
1222222220222222221
1222222220222222221
1222222220222222221
1222222220222222221
1222222220222222221
1222222220222222221
1222222220222222221
1222222220222222221
1222222220222222221
1222222220222222221
1222222220222222221
1222222220222222221
1222222220222222221
1222222220222222221
1222222220222222221
1222222220222222221
1222222220222222221
1222222220222222221
1222222220222222221
1222222220222222221
1222222220222222221
1222222220222222221
1222222220222222221
1222222220222222221
1222222220222222221
1222222220222222221
1222222220222222221
1222222220222222221
1222222220222222221
1222222220222222221
1222222220222222221
1222222220222222221
1222222220222222221
1222222220222222221
1222222220222222221
1222222220222222221
1222222220222222221
1222222220222222221
1222222220222222221
1222222220222222221
1222222220222222221
1222222220222222221
1222222220222222221
1222222220222222221
1222222220222222221
1222222220222222221
1222222220222222221
1222222220222222221
1222222220222222221
1222222220222222221
1222222220222222221
1222222220222222221
1222222220222222221
1222222220222222221
1222222220222222221
1222222220222222221
1222222220222222221
1222222220222222221
1222222220222222221
1222222220222222221
1222222220222222221
1222222220222222221
1222222220222222221
1222222220222222221
1222222220222222221
1222222220222222221
1222222220222222221
1222222220222222221
1222222220222222221
1222222220222222221
1222222220222222221
1222222220222222221
1222222220222222221
1222222220222222221
1222222220222222221
1222222220222222221
1222222220222222221
1222222220222222221
1222222220222222221
1222222220222222221
1222222220222222221
1222222220222222221
1222222220222222221
1222222220222222221
1222222220222222221
1222222220222222221
1222222220222222221
1222222220222222221
1222222220222222221
1222222220222222221
1222222220222222221
1222222220222222221
1222222220222222221
1222222220222222221
1222222220222222221
1222222220222222221
1222222220222222221
1222222220222222221
1222222220222222221
1222222220222222221
1222222220222222221
1222222220222222221
1222222220222222221
1222222220222222221
1222222220222222221
1222222220222222221
1222222220222222221
1222222220222222221
1222222220222222221
1222222220222222221
1222222220222222221
1222222220222222221
1222222220222222221
1222222220222222221
1222222220222222221
1222222220222222221
1222222220222222221
1222222220222222221
1222222220222222221
1222222220222222221
1222222220222222221
1222222220222222221
1222222220222222221
1222222220222222221
1222222220222222221
1222222220222222221
1222222220222222221
1222222220222222221
1222222220222222221
1222222220222222221
1222222220222222221
1222222220222222221
1222222220222222221
1222222220222222221
1222222220222222221
1222222220222222221
1222222220222222221
1222222220222222221
1222222220222222221
1222222220222222221
1222222220222222221
1222222220222222221
1222222220222222221
1222222220222222221
1222222220222222221
1222222220222222221
1222222220222222221
1222222220222222221
1222222220222222221
1222222220222222221
1222222220222222221
1222222220222222221
1222222220222222221
1222222220222222221
1222222220222222221
1222222220222222221
1222222220222222221
1222222220222222221
1222222220222222221
1222222220222222221
1222222220222222221
1222222220222222221
1222222220222222221
1222222220222222221
1222222220222222221
1222222220222222221
1222222220222222221
1222222220222222221
1222222220222222221
1222222220222222221
1222222220222222221
1222222220222222221
1222222220222222221
1222222220222222221
1222222220222222221
1222222220222222221
1222222220222222221
1222222220222222221
1222222220222222221
1222222220222222221
1222222220222222221
1222222220222222221
1222222220222222221
1222222220222222221
1222222220222222221
1222222220222222221
1222222220222222221
1222222220222222221
1222222220222222221
1222222220222222221
1222222220222222221
1222222220222222221
1222222220222222221
1222222220222222221
1222222220222222221
1222222220222222221
1222222220222222221
1222222220222222221
1222222220222222221
1222222220222222221
1222222220222222221
1222222220222222221
1222222220222222221
1222222220222222221
1222222220222222221
1222222220222222221
1222222220222222221
1222222220222222221
1222222220222222221
1222222220222222221
1222222220222222221
1222222220222222221
1222222220222222221
1222222220222222221
1222222220222222221
1222222220222222221
1222222220222222221
1222222220222222221
1222222220222222221
1222222220222222221
1222222220222222221
1222222220222222221
1222222220222222221
1222222220222222221
1222222220222222221
1222222220222222221
1222222220222222221
1222222220222222221
1222222220222222221
1222222220222222221
1222222220222222221
1222222220222222221
1222222220222222221
1222222220222222221
1222222220222222221
1222222220222222221
1222222220222222221
1222222220222222221
1222222220222222221
1222222220222222221
1222222220222222221
1222222220222222221
1222222220222222221
1222222220222222221
1222222220222222221
1222222220222222221
1222222220222222221
1222222220222222221
1222222220222222221
1222222220222222221
1222222220222222221
1222222220222222221
1222222220222222221
1222222220222222221
1222222220222222221
1222222220222222221
122222222N222222221
1111111111111111111


